11 13
0 0 0 0 0 0 0 0 0 0 0 0 0
0 2 2 1 2 3 2 2 4 1 2 2 0
0 1 0 1 0 1 0 1 0 1 0 1 0
0 2 2 2 2 2 2 2 2 2 2 2 0
0 3 0 1 0 1 0 1 0 1 0 3 0
0 2 4 2 2 2 4 2 2 2 4 2 0
0 1 0 1 0 1 0 1 0 1 0 1 0
0 2 2 2 2 3 2 2 2 2 2 2 0
0 3 0 1 0 1 0 1 0 1 0 3 0
0 2 2 4 2 2 2 4 2 2 2 2 0
0 0 0 0 0 0 0 0 0 0 0 0 0
