11 13
1 1 1 1 1 1 1 1 1 1 1 1 1
1 0 0 0 2 5 1 1 2 3 2 0 1
1 0 0 0 0 2 3 1 1 0 1 0 1
1 0 0 0 2 4 2 1 0 2 4 2 1
1 1 2 2 2 1 1 1 1 0 1 0 1
1 0 2 5 2 0 3 0 2 4 2 0 1
1 1 1 0 1 0 1 0 1 0 1 0 1
1 3 0 2 4 2 0 5 2 0 2 3 1
1 0 1 0 1 0 1 0 1 0 1 0 1
1 0 2 3 0 2 0 2 0 4 0 0 1
1 1 1 1 1 1 1 1 1 1 1 1 1
