11 13
0 0 0 0 0 0 0 0 0 0 0 0 0
0 3 3 2 3 4 3 3 4 2 3 3 0
0 2 1 2 1 2 1 2 1 2 1 2 0
0 3 3 3 3 3 3 3 3 3 3 3 0
0 4 1 2 1 2 1 2 1 2 1 4 0
0 3 4 3 3 3 4 3 3 3 4 3 0
0 2 1 2 1 2 1 2 1 2 1 2 0
0 3 3 3 3 4 3 3 3 3 3 3 0
0 4 1 2 1 2 1 2 1 2 1 4 0
0 3 3 4 3 3 3 4 3 3 3 3 0
0 0 0 0 0 0 0 0 0 0 0 0 0
